concur - соглашаться
obstruct - препятствовать
preclude - мешать, препятствовать
seek - искать
intercourse - связь, контакт
selfless - неэгоистичный
converse - общаться, преобрзовывать
prudent - разумный
commitment - обязательство, приверженность
remuneration - вознаграждение
combat - бороться, противостоять
forfeit - потерять, лишиться, неустойка
deteriorate - ухудшаться
deflect - отклонять, уводить 
innocuous - безобидный 
irrespective - независимо
empower - уполномачивать, позволять
furthemore - кроме того
contribute - способствовать
omit - упустить
deficiency - дефицит
figurative expression - образное выражение
fare - плата за проезд
propose - предлагать
ponder - обумывать, размышлять
situate - располагать, поместить
perish - погибнуть, исчезнуть
unconscious - бессознательный
persevere - упорно продолжать, настойчиво добиваться
pass out - раздать, потерять сознание
retrieve - возвращать, найти
premonition - предчувствие
assess - оценивать